00000000000000000000000000000000000000000000000000000000000000000000000000000000000000000000000000000000000000000000000000000000000000000000000000000000000000000000000000000000000000000000000000000000
00000011111011111011111011111011111011111011111011111011111011111011111011111011111011111011111011111011111011111011111011111011111011111011111011111011111011111011111011111011111011111000000000000000
00000011111011111011111011111011111011111011111011111011111011111011111011111011111011111011111011111011111011111011111011111011111011111011111011111011111011111011111011111011111011111000000000000000
00000011111011111011111011111011111011111011111011111011111011111011111011111011111011111011111011111011111011111011111011111011111011111011111011111011111011111011111011111011111011111000000000000000
00000000100000100000100000100000100000100000100000100000100000100000100000100000100000100000100000100000100000100000100000100000100000100000100000100000100000100000100000100000100000100000000000000000
00000111111111111111111111111111111111111111111111111111111111111111111111111111111111111111111111111111111111111111111111111111111111111111111111111111111111111111111111111111111111111100000000000000
01110111111111111111111111111111111111111111111111111111111111111111111111111111111111111111111111111111111111111111111111111111111111111111111111111111111111111111111111111111111111111101110000000000
01110111111111111111111111111111111111111111111111111111111111111111111111111111111111111111111111111111111111111111111111111111111111111111111111111111111111111111111111111111111111111101110000000000
01111111000000001000001000001000001000001000001000001000001000001000001000001000001000001000000001110000000010000010000010000010000010000010000010000010000010000010000010000010000000011111110000000000
01110111000000111110111110111110111110111110111110111110111110111110111110111110111110111110000001110000001111101111101111101111101111101111101111101111101111101111101111101111100000011101110000000000
01110111000000111110111110111110111110111110111110111110111110111110111110111110111110111110000001110000001111101111101111101111101111101111101111101111101111101111101111101111100000011101110000000000
00000111000000111110111110111110111110111110111110111110111110111110111110111110111110111110000001110000001111101111101111101111101111101111101111101111101111101111101111101111100000011100000000000000
01110111000000000000000000000000000000000000000000000000000000000000000000000000000000000000000001110000000000000000000000000000000000000000000000000000000000000000000000000000000000011101110000000000
01110111000000000000000000000000000000000000000000000000000000000000000000000000000000000000000001110000000000000000000000000000000000000000000000000000000000000000000000000000000000011101110000000000
01111111011100000000000000000000000000000000000000000000000000000000000000000000000000000000011101110111000000000000000000000000000000000000000000000000000000000000000000000000000111011111110000000000
01110111011100000000000000000000000000000000000000000000000000000000000000000000000000000000011101110111000000000000000000000000000000000000000000000000000000000000000000000000000111011101110000000000
01110111111100000000000000000000000000000000000000000000000000000000000000000000000000000000011111111111000000000000000000000000000000000000000000000000000000000000000000000000000111111101110000000000
00000111011100000000000000000000000000000000000000000000000000000000000000000000000000000000011101110111000000000000000000000000000000000000000000000000000000000000000000000000000111011100000000000000
01110111011100000000000000000000000000000000000000000000000000000000000000000000000000000000011101110111000000000000000000000000000000000000000000000000000000000000000000000000000111011101110000000000
01110111000000000000000000000000000000000000000000000000000000000000000000000000000000000000000001110000000000000000000000000000000000000000000000000000000000000000000000000000000000011101110000000000
01111111011100000000000000000000000000000000000000000000000000000000000000000000000000000000011101110111000000000000000000000000000000000000000000000000000000000000000000000000000111011111110000000000
01110111011100000000000000000000000000000000000000000000000000000000000000000000000000000000011101110111000000000000000000000000000000000000000000000000000000000000000000000000000111011101110000000000
01110111111100000000000000000000000000000000000000000000000000000000000000000000000000000000011111111111000000000000000000000000000000000000000000000000000000000000000000000000000111111101110000000000
00000111011100000000000000000000000000000000000000000000000000000000000000000000000000000000011101110111000000000000000000000000000000000000000000000000000000000000000000000000000111011100000000000000
01110111011100000000000000000000000000000000000000000000000000000000000000000000000000000000011101110111000000000000000000000000000000000000000000000000000000000000000000000000000111011101110000000000
01110111000000000000000000000000000000000000000000000000000000000000000000000000000000000000000001110000000000000000000000000000000000000000000000000000000000000000000000000000000000011101110000000000
01111111011100000000000000000000000000000000000000000000000000000000000000000000000000000000011101110111000000000000000000000000000000000000000000000000000000000000000000000000000111011111110000000000
01110111011100000000000000000000000000000000000000000000000000000000000000000000000000000000011101110111000000000000000000000000000000000000000000000000000000000000000000000000000111011101110000000000
01110111111100000000000000000000000000000000000000000000000000000000000000000000000000000000011111111111000000000000000000000000000000000000000000000000000000000000000000000000000111111101110000000000
00000111011100000000000000000000000000000000000000000000000000000000000000000000000000000000011101110111000000000000000000000000000000000000000000000000000000000000000000000000000111011100000000000000
01110111011100000000000000000000000000000000000000000000000000000000000000000000000000000000011101110111000000000000000000000000000000000000000000000000000000000000000000000000000111011101110000000000
01110111000000000000000000000000000000000000000000000000000000000000000000000000000000000000000001110000000000000000000000000000000000000000000000000000000000000000000000000000000000011101110000000000
01111111011100000000000000000000000000000000000000000000000000000000000000000000000000000000011101110111000000000000000000000000000000000000000000000000000000000000000000000000000111011111110000000000
01110111011100000000000000000000000000000000000000000000000000000000000000000000000000000000011101110111000000000000000000000000000000000000000000000000000000000000000000000000000111011101110000000000
01110111111100000000000000000000000000000000000000000000000000000000000000000000000000000000011111111111000000000000000000000000000000000000000000000000000000000000000000000000000111111101110000000000
00000111011100000000000000000000000000000000000000000000000000000000000000000000000000000000011101110111000000000000000000000000000000000000000000000000000000000000000000000000000111011100000000000000
01110111011100000000000000000000000000000000000000000000000000000000000000000000000000000000011101110111000000000000000000000000000000000000000000000000000000000000000000000000000111011101110000000000
01110111000000000000000000000000000000000000000000000000000000000000000000000000000000000000000001110000000000000000000000000000000000000000000000000000000000000000000000000000000000011101110000000000
01111111011100000000000000000000000000000000000000000000000000000000000000000000000000000000011101110111000000000000000000000000000000000000000000000000000000000000000000000000000111011111110000000000
01110111011100000000000000000000000000000000000000000000000000000000000000000000000000000000011101110111000000000000000000000000000000000000000000000000000000000000000000000000000111011101110000000000
01110111111100000000000000000000000000000000000000000000000000000000000000000000000000000000011111111111000000000000000000000000000000000000000000000000000000000000000000000000000111111101110000000000
00000111011100000000000000000000000000000000000000000000000000000000000000000000000000000000011101110111000000000000000000000000000000000000000000000000000000000000000000000000000111011100000000000000
01110111011100000000000000000000000000000000000000000000000000000000000000000000000000000000011101110111000000000000000000000000000000000000000000000000000000000000000000000000000111011101110000000000
01110111000000000000000000000000000000000000000000000000000000000000000000000000000000000000000001110000000000000000000000000000000000000000000000000000000000000000000000000000000000011101110000000000
01111111011100000000000000000000000000000000000000000000000000000000000000000000000000000000011101110111000000000000000000000000000000000000000000000000000000000000000000000000000111011111110000000000
01110111011100000000000000000000000000000000000000000000000000000000000000000000000000000000011101110111000000000000000000000000000000000000000000000000000000000000000000000000000111011101110000000000
01110111111100000000000000000000000000000000000000000000000000000000000000000000000000000000011111111111000000000000000000000000000000000000000000000000000000000000000000000000000111111101110000000000
00000111011100000000000000000000000000000000000000000000000000000000000000000000000000000000011101110111000000000000000000000000000000000000000000000000000000000000000000000000000111011100000000000000
01110111011100000000000000000000000000000000000000000000000000000000000000000000000000000000011101110111000000000000000000000000000000000000000000000000000000000000000000000000000111011101110000000000
01110111000000000000000000000000000000000000000000000000000000000000000000000000000000000000000001110000000000000000000000000000000000000000000000000000000000000000000000000000000000011101110000000000
01111111011100000000000000000000000000000000000000000000000000000000000000000000000000000000011101110111000000000000000000000000000000000000000000000000000000000000000000000000000111011111110000000000
01110111011100000000000000000000000000000000000000000000000000000000000000000000000000000000011101110111000000000000000000000000000000000000000000000000000000000000000000000000000111011101110000000000
01110111111100000000000000000000000000000000000000000000000000000000000000000000000000000000011111111111000000000000000000000000000000000000000000000000000000000000000000000000000111111101110000000000
00000111011100000000000000000000000000000000000000000000000000000000000000000000000000000000011101110111000000000000000000000000000000000000000000000000000000000000000000000000000111011100000000000000
01110111011100000000000000000000000000000000000000000000000000000000000000000000000000000000011101110111000000000000000000000000000000000000000000000000000000000000000000000000000111011101110000000000
01110111000000000000000000000000000000000000000000000000000000000000000000000000000000000000000001110000000000000000000000000000000000000000000000000000000000000000000000000000000000011101110000000000
01111111011100000000000000000000000000000000000000000000000000000000000000000000000000000000011101110111000000000000000000000000000000000000000000000000000000000000000000000000000111011111110000000000
01110111011100000000000000000000000000000000000000000000000000000000000000000000000000000000011101110111000000000000000000000000000000000000000000000000000000000000000000000000000111011101110000000000
01110111111100000000000000000000000000000000000000000000000000000000000000000000000000000000011111111111000000000000000000000000000000000000000000000000000000000000000000000000000111111101110000000000
00000111011100000000000000000000000000000000000000000000000000000000000000000000000000000000011101110111000000000000000000000000000000000000000000000000000000000000000000000000000111011100000000000000
01110111011100000000000000000000000000000000000000000000000000000000000000000000000000000000011101110111000000000000000000000000000000000000000000000000000000000000000000000000000111011101110000000000
01110111000000000000000000000000000000000000000000000000000000000000000000000000000000000000000001110000000000000000000000000000000000000000000000000000000000000000000000000000000000011101110000000000
01111111011100000000000000000000000000000000000000000000000000000000000000000000000000000000011101110111000000000000000000000000000000000000000000000000000000000000000000000000000111011111110000000000
01110111011100000000000000000000000000000000000000000000000000000000000000000000000000000000011101110111000000000000000000000000000000000000000000000000000000000000000000000000000111011101110000000000
01110111111100000000000000000000000000000000000000000000000000000000000000000000000000000000011111111111000000000000000000000000000000000000000000000000000000000000000000000000000111111101110000000000
00000111011100000000000000000000000000000000000000000000000000000000000000000000000000000000011101110111000000000000000000000000000000000000000000000000000000000000000000000000000111011100000000000000
01110111011100000000000000000000000000000000000000000000000000000000000000000000000000000000011101110111000000000000000000000000000000000000000000000000000000000000000000000000000111011101110000000000
01110111000000000000000000000000000000000000000000000000000000000000000000000000000000000000000001110000000000000000000000000000000000000000000000000000000000000000000000000000000000011101110000000000
01111111011100000000000000000000000000000000000000000000000000000000000000000000000000000000011101110111000000000000000000000000000000000000000000000000000000000000000000000000000111011111110000000000
01110111011100000000000000000000000000000000000000000000000000000000000000000000000000000000011101110111000000000000000000000000000000000000000000000000000000000000000000000000000111011101110000000000
01110111111100000000000000000000000000000000000000000000000000000000000000000000000000000000011111111111000000000000000000000000000000000000000000000000000000000000000000000000000111111101110000000000
00000111011101111111111111111111111111111111111111111111111111111111111111111111111111111110011101110111011111111111111111111111111111111111111111111111111111111111111111111111100111011100000000000000
01110111011101111111111111111111111111111111111111111111111111111111111111111111111111111110011101110111011111111111111111111111111111111111111111111111111111111111111111111111100111011101110000000000
01110111000001111111111111111111111111111111111111111111111111111111111111111111111111111110000001110000011111111111111111111111111111111111111111111111111111111111111111111111100000011101110000000000
01111111000000001000001000001000001000001000001000001000001000001000001000001000001000001000000001110000000010000010000010000010000010000010000010000010000010000010000010000010000000011111110000000000
01110111111111111111111111111111111111111111111111111111111111111111111111111111111111111111111111111111111111111111111111111111111111111111111111111111111111111111111111111111111111111101110000000000
01110111111111111111111111111111111111111111111111111111111111111111111111111111111111111111111111111111111111111111111111111111111111111111111111111111111111111111111111111111111111111101110000000000
00000111111111111111111111111111111111111111111111111111111111111111111111111111111111111111111111111111111111111111111111111111111111111111111111111111111111111111111111111111111111111100000000000000
00000000100000100000100000100000100000100000100000100000100000100000100000100000100000100000100000100000100000100000100000100000100000100000100000100000100000100000100000100000100000100000000000000000
00000011111011111011111011111011111011111011111011111011111011111011111011111011111011111011111011111011111011111011111011111011111011111011111011111011111011111011111011111011111011111000000000000000
00000011111011111011111011111011111011111011111011111011111011111011111011111011111011111011111011111011111011111011111011111011111011111011111011111011111011111011111011111011111011111000000000000000
00000011111011111011111011111011111011111011111011111011111011111011111011111011111011111011111011111011111011111011111011111011111011111011111011111011111011111011111011111011111011111000000000000000
00000000000000000000000000000000000000000000000000000000000000000000000000000000000000000000000000000000000000000000000000000000000000000000000000000000000000000000000000000000000000000000000000000000
00000000000000000000000000000000000000000000000000000000000000000000000000000000000000000000000000000000000000000000000000000000000000000000000000000000000000000000000000000000000000000000000000000000
00000000000000000000000000000000000000000000000000000000000000000000000000000000000000000000000000000000000000000000000000000000000000000000000000000000000000000000000000000000000000000000000000000000
