000000000000000000000000000000
111111111111101111111111111111
S10000000001111111111110000000
000000000011100000000010000000
000000000001100000000010000000
000001111111100001111111000000
011111100000100000100000000000
000000000011111111111111111111
011111111111100000000000111G10
000000000001000000000000000000
