000G1110
11001110
S1011110
11111110
11111110